Мех. колебания виртуальная лабораторная работа 1_3
1. Колебание 	- периодически повторяющееся движения тела.
2. Период колебаний 	- минимальное время, через которое движение полностью повторяется.
3. Частота колебаний 	- количество полных колебаний за единицу времени.
4. Гармонические колебаний 	- движение, при котором координата тела меняется со временем по закону синуса или косинуса.
5. Запишите закон зависимости от времени характеристики А, совершаю-щей гармоническое колебательное изменение 	- А = Ао*Cos(ω0 t + ϕ0) .
6. Запишите закон движения МТ, совершающей гармонические колебания 	- x = A cos(или sin) (ω t + ϕ0)
7. Гармонические колебаний	- модуль наибольшего смещения тела от положения равновесия
8. Фаза гармонических колебаний	- аргумент периодической функции, описывающей колебательный или волновой процесс (cos || sin).	
9. Начальная фаза гармонических колебаний	- значение фазы колебаний в начальный момент времени, то есть при t = 0.
10. Напишите уравнение связи частоты и периода гармонических колебаний 	- частота f, период Т, связь f=1/T.
11. Напишите уравнение связи частоты и циклической частоты гармони-ческих колебаний. 	- w=2pi*f.
12. Напишите формулу зависимости скорости МТ от времени при гар-монических колебаниях. 	- x = A*sin(wt + b), скорость v = x'(t) = A*w*cos(wt+b).
13. Напишите уравнения связи амплитуды скорости и амплитуды смещения при гармонических колебаниях МТ. 	- B=A*w, где B - амплитуда скорости.
14. Напишите формулу зависимости ускорения МТ от времени при гармонических колебаниях. 	- ускорение a=v'(t)=-A*w^2*sin(wt+b)
15. Напишите уравнения связи амплитуды скорости и амплитуды ускорения при гармонических колебаниях МТ. 	- C=A*w^2, где C - амплитуда ускорения.
16. Напишите уравнения связи амплитуды смещения и амплитуды ускорения при гармонических колебаниях МТ.	- A*w^2=C.
17. Напишите дифференциальное уравнение свободных гармонических колебаний МТ.	- d^2A/dt^2 + ω0^2A = 0
18. Напишите дифференциальное уравнение свободных затухающих колебаний МТ.		- d^2A/dt^2 + 2B*dA/dt + ω0^2A = 0, где B - коэффициент затухания .
19. Что определяет коэффициент затухания?	- это величина, обратная времени, за которое амплитуда колебания уменьшилась в ee раз.
21. Запишите формулу циклической частоты свободных колебаний математического маятника.	- ωo = 1/2pi * (g/l)^1/2
22. Дайте определение пружинного маятника. 	- механическая система, состоящая из пружины с коэффициентом упругости , один конец которой жёстко закреплён, а на втором находится груз.
23. Запишите формулу циклической частоты свободных колебаний пружинного маятника. 	- ω = (m/k)^1/2
24. Какие процессы происходят при вынужденных колебаниях? 	 - колебания, возникающие под воздействием внешней переодически изменяющейся силы.
25. Что такое резонанс?	-  если частота v внешней силы сопдает с частотой v свободных колебаний системы, амплитуда колебайнний резко воврастает 
26. При каком затухании резонанс будет более резким? 	- с уменьшением коэфициента 	заьухания увеличивается резоонансная величина
